10 08 01
XXXXXXXXXX
X.....X.GX
X.J......X
X.MXXG..JX
X...XXXX.X
X.J.....GX
X........X
XXXXXXXXXX