10 09 04
     XXXXX
XXXXXX...X
X........X
X..JXXX.XX
XX.JG.G.GX
 X.JX....X
 X.MXXXXXX
 X..X
 XXXX
