10 09 04
     XXXXX
XXXXXX..MX
X..J.....X
X..JXXX.XX
XXGJG.G.GX
 X.JX....X
 X..XXXXXX
 X..X
 XXXX
