10 09 03
     XXXXX
XXXXXX...X
X..J.....X
X..JXXX.XX
XX.JG.G.GX
 X..X....X
 X.MXXXXXX
 X..X
 XXXX
